XXXXXXXXX
P       X
X XXXXX X
X X   X X
X X X X X
X X X   X
X X XXXXX
X X     K
XXXXXXXXX
