XXXXXXXXXXXXXXXXXXXXXXXXXXXXXXXXXXXXXXXXXXXXXXXXXXXXXXXXXXXXXXXXXXXXXXXXXXXXXXXXXXXXXXXXXXXXXXXXXXXXXXXXXXXXXXXXXXXXXXXXXXXXXXXXXXXXXXXXXXXXXXXXXXXXXXXXXXXXXXXXXXXXXXXXXXXXXXXXXXXXXXXXXXXXXXXXXXXXXXXXXXXXXXXXXXXXXXXXXXXXXXXXXXXXXXXXXXXXXXXXXXXXXXXXXXXXXXXXXXXXXXXXXXXXXXXXXXXXXXXXXXXXXXXXXXXXXXXXXXXXX
P                   X           X                   X   X       X             X   X                     X   X         X               X   X       X             X       X       X         X       X             X X                 X   X       X       X                 X     X           X       X   X   X
X XXXXXXXXX XXXXXXX X XXXXXXXXX X XXX XXXXXXXXXXXXX X XXX XXX XXX XXXXXXXXXXX X XXX XXXXXXXXXXX X XXXXXXX X X XXXXX XXX XXXXXXX XXXXX X X X XXXXXXX XXXXX XXXXX X X XXXXX X XXXXX XXX X XXX XXX XXX XXX XXXXXXX X X XXXXXXXXXXX XXX X X X XXXXX X XXX X XXXXX XXXXX XXXXX XXX X X XXX XXXXXXX X XXXXX X X X X
X       X   X     X X X     X   X   X X       X   X X X   X X     X     X     X     X   X   X   X X   X   X X X   X     X     X     X   X   X     X   X   X   X X X X     X     X   X X X   X X       X       X   X X X       X   X   X   X   X X X   X     X     X   X X   X X X X X         X X   X X   X X
XXXXXXX X XXX XXXXX X X XXX XXX XXXXX X X XXX X X X X X XXX XXXXXXX XXXXX XXXXX XXXXX X XXX X XXXXX X X XXX X XXX XXXXXXX XXX XXXXX XXXXXXXXX XXX X XXX X X X X X X X XXXXXXXXX XXX X XXX XXX XXXXXXXXXXX XXX XXX X X X X XXXXX X XXXXXXXXX XXX XXX XXXXXXX XXXXXXXXX X XXX X XXX X XXXXXXXXXXX X X X XXXXX X
X     X X   X X     X X X X   X X   X X X X     X X X X     X   X     X   X   X   X   X   X X     X X   X   X   X     X   X       X X     X   X   X X   X X X X X X X   X     X   X X   X X X     X     X X   X X X X   X X   X X X     X     X     X     X X         X     X   X X         X X   X X X     X
XXX X X XXX X X XXXXX X X XXX X X X X XXX XXXXXXX X X XXXXX X X XXX X X XXX XXXXX X XXXXX X XXXXX X XXXXX XXXXX XXX X XXXXX XXXXX X X XXX X XXX XXX X XXXXX X X X X XXX X XXX XXX X XXX X X X X X X XXX X X XXX X X XXX X X X XXX X XXX X XXX XXXXXXX XXX X X XXXXXXXXX XXXXX X X XXXXXXX X X XXXXX X X XXXXX
X   X X X   X X     X   X   X X X X X   X     X   X X X     X X   X X X X X   X   X   X X     X   X X   X     X X   X       X   X X     X X   X     X X   X X X X X     X   X   X   X   X X   X X X X X X X X     X   X X X X   X X   X X   X X     X X X   X     X   X X   X X X         X   X   X   X     X
X XXXXX X XXX XXXXX X XXX X X X X X XXX X XXX XXXXX X X XXXXX XXX XXX X X X X X XXXXX X XXXXX X XXX XXX XXX XXX X XXXXXXXXXXX XXX XXXXXXX XXX XXXXXXX X X X X XXX XXXXXXXXX X XXXXXXX X X XXX X XXX X X XXX X XXXXXXX XXX X XXX X X XXX XXXXX X X XXX X XXXXXXXXX XXX X XXX X X XXXXXXXXXXXXX XXX XXXXXXXXX X
X     X X X         X     X X X   X     X   X         X X     X       X X   X         X       X X   X     X   X   X   X   X       X   X     X X X     X X   X     X         X X   X   X X   X X X   X     X X   X     X   X X   X X X   X   X   X X   X           X   X   X X X         X   X     X       X X
X XXX X X X XXXXXXXXXXXXXXX X XXXXXXXXXXXXX XXXXXXXXX X X X XXXXX XXXXX XXXXXXXXXXX XXXXXXXXXXX X XXX XXX XXX XXXXX X XXX X XXXXXXX X X XXXXX X X XXXXX XXXXXXXXXXXXX XXXXXXX X X X XXX XXX XXX X XXXXXXX X XXXXX XXXXX X X X XXX X X XXX X XXXXX X XXXXXXXXX XXXXX XXXXX X X XXX XXXXXXX X XXXXX X XXX XXX X
X X X   X X X             X X X             X     X   X X X X   X X     X         X X     X   X X X   X X   X       X   X X X       X X X   X X X X   X X           X X   X   X X   X     X X   X     X     X     X     X X X     X X X   X   X   X X     X   X   X     X X X   X         X     X X X   X   X
X X XXXXX X XXX X XXXXXXXXX X XXXXXXXXXXX XXX XXX XXXXX X XXX X X X XXXXX XXXXXXX XXX XXX X X X X XXX X XXX XXXXXXX XXX X X XXXXX XXX X X X X X X X X X X XXX XXXXX X XXX X XXX XXXXXXXXXXX X X XXXXX XXXXX X XXXXXXXXX X X XXXXXXX X X XXXXX X X X X XXX X XXXXX X X XXX X X XXXXX XXXXXXXXXXX X XXX X X X X
X   X   X X   X X X         X           X   X   X X   X X X   X X X X     X     X     X X   X X   X   X X   X X     X   X X   X   X   X   X   X X X X   X   X X   X   X   X   X     X         X X   X   X X X X         X X X       X       X X X X   X X   X     X X     X X X   X           X X     X X X X
XXXXX X X XXX XXX X XXXXXXXXXXXXXXXXXXX XXXXX XXX X X X X X XXX XXX X XXXXXXX X XXXXXXX XXXXX XXX X XXX X XXX X XXXXX XXX XXX X XXXXX XXXXXXXXX X X XXXXXXXXX X X XXXXX X XXX XXXXX X XXXXXXXXXXX X XXX X X X XXX XXXXXXX X X XXXXXXXXXXXXXXX X XXXXXXX XXXXX XXX X XXXXXXX X X X XXXXXXX XXXXX X XXXXXXX X X
X     X X   X   X   X     X         X X     X X   X X X   X X       X   X   X X         X   X   X X X   X   X X X   X X     X X     X   X       X   X       X   X     X X X   X X   X   X       X X     X   X X   X X     X             X     X X     X     X   X X X     X   X X X     X X   X X X       X X
X XXXXX X X XXX X XXXXX X X XXX XXX X XXXXX X X X X X XXX X XXXXXXXXXXX X X X XXXXX XXX XXX XXX X X X XXXXX X X XXX X X X X X XXXXX XXX X X XXXXXXX X XXX X XXXXXXXXX X XXX XXX X XXXXX X XXXXX X XXXXXXXXXXX X XXX X XXXXXXXXXXXXXXXXX X XXXXX X X X XXXXX X X XXX X X X X XXX X X X XXX X X X X X XXX XXXXX
X X   X X X X X X       X X   X X     X   X   X X X X   X X     X       X X X   X   X       X   X   X     X   X   X   X X X X X     X X   X X     X X X   X           X       X X X     X   X     X             X       X     X     X X X X   X   X X   X   X X     X X X X   X X X X     X X X X X X   X   X
X X XXX XXX X X XXXXXXXXX XXX X XXXXX X X XXXXX XXX XXX X XXXXX X XXXXXXX X XXXXX XXX XXXXXXX XXXXXXXXX X XXX XXX XXX XXX X X X XXXXX XXXXX X XXX X XXX XXXXXXXXX XXXXXXXXXXX X X X XXXXXXX XXXXXXX XXXXXXXXXXXXX XXXXXXX XXX X XXX X X X XXX X XXX XXX X XXX XXXXXXXXX XXXXX X X XXXXXXXXX X X X X X XXX X X
X X         X     X     X   X X   X     X     X     X   X     X X X       X       X X X X     X   X     X   X X X   X     X X   X   X       X X   X     X       X X   X     X   X X   X   X   X   X   X X       X   X     X     X   X   X   X   X   X     X   X       X       X X           X   X X X X   X X
X XXXXXXXXXXXXXXX X XXX XXX XXXXX X XXXXXXXXX XXXXXXX X XXXXX X X X XXX X XXXXXXXXX X X X XXXXX XXX X XXXXXXX X XXX XXXXXXXXX XXX X XXXXXXXXX X XXXXXXX X XXXXX XXX X X XXX XXXXX XXX X X XXX X X XXX X X XXXXX XXX X X XXXXXXXXX XXX XXXXX X XXX XXXXXXX X XXX XXXXX XXXXXXX X XXXXXXX XXXXXXX X X XXX XXX X
X     X       X X   X X   X       X   X   X     X X   X   X   X X X X X X X   X         X X     X   X             X X   X     X   X     X     X       X X X   X     X   X X     X X   X X   X X X   X X X X       X X X X   X   X X     X   X   X X     X X X X   X     X   X X X     X X   X   X X     X   X
X XXX X XXXXX X XXXXX XXX XXXXXXXXX XXX X XXXXX X X XXXXXXX XXX X X X X XXX X XXX XXXXXXX X XXXXX XXXXXXX XXXXXXXXX X X X XXXXX XXXXXXX X XXXXXXXXXXX X X XXX XXXXXXXXXXX XXXXX X X XXX XXX X X XXX X X X XXXXXXX X X XXX X X X X XXXXX X XXXXXXX X XXX XXX X X X XXXXX X X XXX X XXX XXX X XXXXX XXXXXXX X X
X X X   X   X X                   X X   X   X     X X     X X X   X   X X   X   X X       X   X   X X   X     X     X X     X   X X   X X X     X     X X X     X     X   X     X X X X   X   X X X   X X X     X X X     X X X X     X X       X   X X     X   X   X     X   X X   X   X X         X     X X
X X XXXXX X X X XXXXXXXXXXXXXXXXX XXX XXXXX XXXXXXX X XXX X X XXXXXXX X X XXXXX X X XXXXXXX X X XXX X X XXXXXXX XXX X XXXXXXX XXX X X X X XXX X X XXXXXXX X XXX XXX X XXX X XXXXX X X XXX XXX X X XXXXX X X XXX X X XXXXXXX X X XXXXX X XXXXX X X XXX XXXXXXXXX XXX XXXXXXXXX X XXX XXX X XXXXXXXXXXX XXXXX X
X       X X   X     X     X   X X   X   X X X     X X X X   X         X X X   X X X       X X X   X X X X     X X X X     X   X X   X   X   X X X     X   X X   X   X     X     X X   X X   X X   X     X X X X X X   X     X X X   X X X   X X X X           X X   X   X   X X       X   X   X       X   X X
X XXXXXXX X XXXXXXXXX XXX X X X XXX XXX X X X XXX X X X XXXXX XXXXXXXXX XXX XXX XXXXXXXXX X X XXX X X X X XXX X X X XXXXX X XXX X XXXXXXXXX XXX XXXXX X XXX XXX X XXXXXXX XXXXX X XXX X XXX X XXX X XXX X X X X X XXXXX XXXXX X X XXX X X X XXX X XXXXXXXXX X XXX XXX X XXX X XXXXXXXXXXX X X X XXXXXXX X X X
X X       X X       X   X   X X   X     X X   X     X X       X     X   X     X     X     X X X     X X   X     X   X   X X   X   X         X   X   X   X     X X X X         X X   X X   X X   X   X   X     X X X     X     X   X   X X X   X X X         X   X     X   X X X     X   X   X X X       X X X
X X XXXXXXXXX XXXXX XXX XXXXX X XXXXXXXXX XXX XXXXXXX XXXXX XXX XXX X X XXXXX XXXXX X XXXXXXX X XXXXX XXX XXXXXXX XXX XXX XXX X XXXXXXX XXXXX XXX X XXXXXXXXX X X X X XXXXXXXXX X X X XXX X XXXXXXXXX XXXXXXXXX X X XXXXX XXXXX XXX XXXXX XXX X X X XXXXXXXXXXX XXXXX XXX X X X XXX X X XXXXXXX XXXXX X XXX X
X X           X   X   X X   X X               X     X X   X   X X   X X     X   X X X X X     X   X   X   X     X     X   X   X X       X     X   X   X       X   X X   X       X X X     X X       X   X   X   X   X X   X   X X   X     X X   X   X       X   X   X X   X   X   X X X       X X   X X     X
X XXXXXXXXXXXXX X X XXX XXX X XXX XXXXXXXXXXXXX XXX X X X XXXXX X XXX XXXXX X X X X X X X X XXXXX X XXX XXX XXX XXXXXXX XXX XXX X XXXXXXXXXXX X XXX X X XXXXXXXXXXX XXX X XXXXXXX XXXXXXX X X XXXXX XXX X X X XXXXXXX X X X X XXX XXX XXXXX XXXXXXXXX X XXXXX XXX X X X XXX XXX X X X XXXXXXX X X X XXX XXXXX
X   X     X     X X   X   X X   X   X           X   X X X       X X     X   X X X X   X   X   X   X   X   X X X X       X   X     X         X X X X X   X               X X     X         X       X       X X   X     X X   X   X X   X           X   X X     X   X X X X   X   X X   X   X   X   X   X     X
XXX X XXX XXXXX X XXX XXX X XXX XXXXX XXXXXXXXXXX XXX X XXXXXXXXX X XXX X XXX X X XXXXXXX XXX X XXXXX XXXXX X X X XXXXXXX XXXXXXX X XXXXXXX X X X X XXXXXXX XXXXX XXXXXXX XXX X XXXXX XXXXXXXXXXXXXXXXXXXXXXXXX X XXX X XXXXXXX X XXX X XXXXX X XXX X XXX XXXXXXX X XXX XXX XXX X XXXXXXX X XXXXX XXX XXXXX X
X   X X   X     X   X   X X X   X     X   X     X     X X     X   X   X X     X         X   X X     X         X   X   X X       X X     X   X X   X X     X X   X X     X   X X     X         X           X     X X   X     X X X X   X X     X X   X     X       X   X   X   X X X       X     X   X X   X X
X XXX X XXX XXXXXXX XXX X X X XXX XXXXX X XXX X XXXXXXX X XXX X XXXXXXX XXXXXXXXXXXXXXX XXX X XXXXX XXXXXXXXX XXXXX X X XXXXXXX X XXX XXX XXX XXX X X XXX XXX X XXX XXX XXX X XXXXX XXXXXXXXX X XXXXXXXXX X XXXXX XXXXXXXXX X X X X XXXXX XXXXX X XXXXXXXXXXXXX XXXXX XXX XXX X X X XXXXXXXXXXX X XXX X XXX X
X X   X     X     X X X   X X     X     X   X X         X   X X   X     X   X       X   X   X           X   X       X         X X X   X   X   X   X   X   X   X X   X X   X   X   X X         X     X     X   X X   X       X X   X     X   X   X   X   X       X   X   X X X X X X       X     X X   X   X X
X X XXXXXXXXX XXX X X XXXXX XXXXXXXXXXX XXX X X XXXXXXXXX XXX XXX X XXXXXXX X XXXXX X XXXXXXXXXXXXXXXXX X X XXXXXXXXX XXXXXXXXX X X XXX XXXXX X XXXXXXX XXX XXX X XXX XXX XXXXX X X X XXXXXXXXXXXXX XXXXX XXX X X X X XXXXXXX XXXXXXXXX X X XXXXXXX XXX X X XXXXX X XXX X X X XXX XXX XXX X XXXXXXX XXXXX X X
X X   X   X   X X X       X           X X   X X     X   X X     X X   X   X X X   X   X             X   X X     X     X       X X X   X X   X     X   X     X X X X     X   X   X X X X     X   X   X   X     X   X   X       X         X X X     X   X X X X     X   X X X X   X   X   X X X   X   X   X   X
X X X X X X XXX X XXXXXXX XXX XXXXX X X X XXXXXXXXX X X X X XXX X XXX X X X X X X XXXXXXX XXXXXXXXX XXXXX XXXXX X XXXXX XXXXX X XXXXX X X X XXXXX XXX XXXXXXX X X X X XXX X X XXXXX XXX XXX X X X X X X XXXXXXX XXXXXXX XXXXX X XXXXXXXXXXX X XXX XXX X X X X XXX XXX X X X XXX X X XXXXX X X X X XXX X XXX X
X X X X X   X   X     X X   X X     X X X     X     X X X X   X X     X X   X   X   X     X   X   X   X   X     X X     X   X X     X X X X   X     X       X X   X X X   X X X   X   X X X   X X X X X X   X X X   X     X X X   X         X X X   X X X X X X   X X X   X     X X     X X   X X     X   X X
X X X X XXXXXXX XXX X X XXX XXX XXXXX X XXXXX X XXXXX X X XXX X XXXXXXX XXX XXXXXXX X XXXXX X X X XXX X XXX XXXXX X XXXXXXX X XXX XXX X X XXX XXXXX XXX X X X XXXXX X X XXX X X X XXX X X XXXXX X XXX X X X X X X XXX XXX X X XXX X XXXXXXXXX X X X X X X X XXX XXX X XXXXX XXXXX XXXXX X XXXXX XXXXX XXX XXX
X X X X   X       X X     X   X   X     X   X X X     X X X   X   X     X   X     X   X     X   X X   X   X X     X       X X   X     X     X     X   X X X X       X X X X X X X   X   X   X   X     X   X X X X     X X X       X X     X   X X X X X   X X   X         X X     X   X X     X     X X X   X
X XXX XXX X XXXXX X XXXXXXXXX X X XXXXXXXXX X X X XXXXX XXX X XXXXX XXX X XXX X XXXXXXX XXX XXXXX X XXXXX X XXXXXXXXXXXXX X XXX XXXXXXX XXXXXXXXX XXX XXX X XXXXX XXX X X X X X XXX XXXXX XXX XXX XXXXXXX X X X X XXXXX X XXXXXXXXX X XXX X XXX X XXX X XXX X XXXXX XXXXXXX X XXXXX X X X XXXXXXXXX X X XXX X
X     X   X   X   X   X       X X X   X     X   X X         X X     X X X   X X         X X X   X X     X X         X     X   X X     X   X     X X       X     X X   X X     X   X     X     X   X     X X X   X     X X   X   X     X   X X   X   X X   X X X   X   X     X X X   X X X         X X   X   X
XXXXXXX XXXXX X XXXXX X XXXXXXX X X X X XXXXXXXXX XXXXXXXXXXXXX XXXXX X XXXXX XXXXXXXXXXX X XXX X XXXXX X XXXXXXXXX X XXXXX X X X XXX XXXXX XXX X XXXXXXXXXXXXX X X XXX XXXXX XXX XXXXX X XXXXXXX X XXX XXX X XXXXXXX X XXX X X XXXXXXX X X XXX XXX X XXXXX X X X XXXXX XXXXX X X XXX X X XXXXXXX X XXXXX X X
X X     X     X   X X   X   X   X   X X           X           X X     X     X       X   X X   X       X X X       X   X     X X X X   X   X X X X     X X       X X   X X   X   X     X   X     X X   X X   X   X   X   X   X X         X X X   X   X       X X X X   X   X     X X X X X   X   X   X   X X X
X X XXXXXXX XXXXX X XXXXX X XXXXXXXXX X XXXXXXXXX X XXXXXXXXX X XXXXX XXXXX XXXXXXX X X X XXX XXXXXXXXX X X X XXXXXXXXX XXXXX X X X XXX X X X X XXXXX X X XXXXXXXXXXX X X X XXXXXXXXX XXXXXXX X XXXXX X X XXXXX X X XXXXX XXX XXXXXXXXXXXXX X X X XXXXXXXXXXX X X X X XXX XXXXXXX X X X XXX XXX XXXXX X X X X
X           X             X           X         X           X             X           X     X             X X               X     X     X   X         X               X   X                   X       X   X       X       X                   X X               X   X             X     X             X   X K
XXXXXXXXXXXXXXXXXXXXXXXXXXXXXXXXXXXXXXXXXXXXXXXXXXXXXXXXXXXXXXXXXXXXXXXXXXXXXXXXXXXXXXXXXXXXXXXXXXXXXXXXXXXXXXXXXXXXXXXXXXXXXXXXXXXXXXXXXXXXXXXXXXXXXXXXXXXXXXXXXXXXXXXXXXXXXXXXXXXXXXXXXXXXXXXXXXXXXXXXXXXXXXXXXXXXXXXXXXXXXXXXXXXXXXXXXXXXXXXXXXXXXXXXXXXXXXXXXXXXXXXXXXXXXXXXXXXXXXXXXXXXXXXXXXXXXXXXXXXXX
